type octile
height 3
width 6
map
..@.XX
@..XXX
..@.XX