type octile
height 3
width 10
map
@@@@@@@.@.
@@@@@@@XX.
........@.